3 0 0 0 0 0 0 0 0 0 0 0 0 0 0 1 1 1 0 1 1 5 5 1 5 0 1 13 13 13 13 13 13 13 13 13 13 13 13 13 13 13 4 4 4 4 2 2 2 2
3 0 0 0 0 0 0 0 0 0 0 0 0 0 0 0 0 1 1 5 0 5 1 1 5 1 5 1 5 13 13 13 4 4 4 4 4 4 4 4 4 4 4 4 4 4 2 2 2 2
3 0 0 0 0 0 0 0 0 0 0 0 0 0 0 0 1 1 1 1 1 0 1 0 1 5 1 5 1 1 1 1 1 1 1 1 1 1 1 1 1 1 1 1 1 4 2 2 2 2
3 0 0 0 0 0 0 0 0 0 0 0 0 0 0 1 1 0 2 2 2 2 2 1 0 1 0 5 5 1 1 1 1 1 1 1 1 1 0 1 1 1 1 1 1 1 13 2 2 2
3 0 0 0 0 0 0 0 2 2 2 2 2 2 2 2 2 2 2 2 2 2 2 2 5 1 1 1 1 1 1 1 0 1 1 1 1 1 1 1 1 1 1 1 1 1 1 4 5 5
11 0 0 0 2 2 2 2 2 2 2 2 2 2 2 2 2 2 2 2 2 2 2 1 1 1 1 5 1 1 1 5 1 1 1 1 1 1 1 1 1 1 1 1 1 1 1 1 1 1
2 2 2 2 2 2 2 2 2 2 2 2 2 2 2 2 2 2 2 4 4 4 4 1 1 1 1 1 1 1 1 1 1 1 1 1 1 1 1 1 1 1 1 1 1 1 1 1 1 1
2 2 2 2 2 2 2 2 2 2 2 2 2 2 2 4 4 4 4 4 13 1 1 13 1 1 1 1 1 1 1 1 1 4 1 1 1 1 1 1 1 1 1 1 1 1 1 1 1 1
2 2 2 2 2 2 2 2 2 2 4 4 4 4 4 4 13 1 1 1 1 1 1 0 1 1 1 1 1 1 4 1 1 1 1 1 1 0 1 1 1 1 1 1 0 1 1 4 4 4
2 2 2 2 2 2 2 2 2 4 4 13 1 1 13 1 1 13 1 1 1 1 1 1 1 1 1 1 1 1 1 1 1 1 1 1 1 1 1 1 1 1 1 1 1 1 1 4 4 4
2 2 2 2 2 2 4 4 4 4 1 1 1 1 1 1 1 1 1 1 1 1 1 1 1 1 1 1 1 1 1 1 0 1 1 1 1 1 1 1 1 1 1 1 1 1 1 4 4 4
4 4 4 4 4 4 4 13 13 1 1 1 1 1 1 1 1 1 1 1 1 1 1 1 1 1 1 1 0 1 1 1 1 1 1 1 1 1 1 1 1 1 1 1 1 1 1 4 4 4
4 4 4 13 13 1 1 1 13 1 1 1 1 1 1 1 1 1 0 1 1 1 1 1 1 1 1 1 1 1 1 1 1 1 1 1 1 0 1 1 1 1 1 1 1 1 1 13 4 13
4 4 4 13 1 1 1 1 1 1 1 1 1 1 1 1 1 1 1 1 1 1 1 1 1 4 4 1 1 1 1 1 1 1 1 1 1 1 1 1 1 1 1 1 1 1 1 13 13 13
4 4 4 1 1 1 1 0 1 1 1 1 1 1 1 1 1 1 1 1 4 4 4 5 5 4 4 1 1 1 1 1 1 1 1 1 1 1 1 1 1 1 1 1 1 1 1 13 4 13
4 4 4 1 1 1 1 1 1 1 1 1 1 4 4 1 1 1 4 1 1 1 4 5 5 4 4 1 1 1 1 1 1 1 1 1 1 1 1 5 5 1 1 1 1 1 0 4 4 13
4 4 4 1 1 1 1 1 1 1 1 1 1 1 4 1 1 1 4 1 1 1 4 5 5 4 4 1 1 1 1 1 1 1 1 1 1 1 1 5 5 1 1 1 1 1 1 4 4 4
4 4 13 1 1 1 1 1 1 1 1 1 1 4 4 1 1 1 1 1 1 4 4 5 5 4 4 1 1 1 1 1 1 0 1 1 1 1 1 5 5 1 1 1 1 1 1 13 13 13
4 4 13 1 1 1 1 1 1 1 1 1 1 1 4 4 1 1 1 1 4 4 4 5 5 4 4 1 1 1 1 1 1 1 1 1 1 1 1 5 5 1 1 1 1 1 1 13 4 13
4 4 13 1 1 1 1 1 1 1 1 1 1 1 1 4 1 1 1 1 4 1 4 5 5 4 4 1 1 1 1 1 1 1 1 13 1 1 1 5 5 1 1 1 1 1 1 4 4 13
4 4 13 1 1 1 0 1 1 1 0 1 1 1 1 4 4 1 1 1 1 1 4 5 5 4 4 1 13 1 1 1 1 1 1 1 1 1 1 5 5 1 1 1 1 1 1 4 4 13
4 4 13 1 1 1 1 1 1 1 1 1 1 1 1 1 4 1 0 1 1 1 4 5 5 4 4 1 1 1 1 1 13 1 1 1 1 1 1 5 5 1 1 1 1 1 1 13 4 13
13 4 4 1 1 1 1 3 1 12 1 12 1 1 1 1 1 1 1 1 1 1 4 5 5 4 4 13 1 1 13 13 13 1 1 1 1 0 1 5 5 1 13 1 1 1 1 4 13 13
4 4 4 1 1 1 4 7 2 2 2 2 2 1 1 1 1 1 4 1 1 1 4 5 5 4 4 4 4 13 13 4 4 4 4 4 13 4 4 5 5 1 6 12 12 10 4 13 13 13
4 4 4 1 1 1 1 2 2 2 2 2 2 1 1 1 1 1 1 1 1 1 4 5 5 4 4 4 4 4 4 4 4 4 4 4 4 4 4 5 5 13 7 0 4 3 13 4 4 13
4 4 4 1 1 1 2 2 2 2 5 2 2 2 11 1 1 1 4 1 1 1 1 5 5 5 5 5 5 5 5 5 5 5 5 5 5 5 5 5 5 0 1 14 14 3 13 4 13 1
4 4 4 1 3 2 2 2 2 2 2 5 2 2 2 1 1 1 1 1 1 0 1 5 5 5 5 5 5 5 5 5 5 5 5 5 5 5 5 5 5 5 1 1 14 3 13 13 13 4
4 4 4 1 1 1 2 2 5 2 2 2 2 2 2 2 1 1 1 1 1 1 1 5 5 0 4 4 4 4 4 4 4 4 4 1 13 1 13 1 1 13 3 0 4 3 13 13 4 4
4 4 13 1 13 11 2 2 2 2 2 2 2 2 2 11 1 12 12 1 1 1 0 5 5 0 4 4 13 1 13 1 4 4 4 4 4 4 4 1 1 13 7 12 12 11 4 13 4 4
4 13 4 1 1 1 1 1 5 5 5 5 2 5 5 5 1 1 1 5 5 1 5 5 5 0 4 1 1 1 1 1 1 1 1 1 1 1 1 1 1 1 1 13 1 1 1 13 1 4
13 4 4 1 1 1 1 5 2 5 2 5 5 5 5 5 1 5 1 1 5 5 5 5 5 4 4 1 13 1 1 1 1 1 1 1 1 1 1 1 1 1 1 1 1 1 1 13 4 4
4 4 13 1 6 8 2 2 2 2 2 2 2 2 2 1 1 1 1 4 1 1 4 5 5 4 4 1 1 1 1 1 1 1 1 1 1 1 1 1 1 1 1 1 1 1 1 13 4 13
4 4 4 13 7 2 2 2 2 2 2 2 2 2 2 2 1 1 1 4 1 0 4 5 5 4 1 13 1 1 1 1 1 1 1 1 1 1 1 1 1 1 1 1 1 1 1 13 4 13
4 4 4 1 4 1 2 2 5 2 5 5 5 2 2 7 1 1 1 4 4 1 4 5 5 4 13 1 1 1 1 1 1 1 1 1 1 1 1 1 1 1 1 1 1 1 1 13 4 13
4 4 4 1 1 1 2 2 2 2 5 2 2 2 1 1 1 1 1 1 4 1 4 5 5 4 13 13 1 1 1 1 1 1 1 1 1 1 1 1 1 1 1 1 1 1 1 13 13 13
4 13 4 1 1 1 13 2 2 2 2 2 1 1 13 1 1 1 1 4 4 1 4 5 5 4 4 1 1 1 1 1 1 1 1 1 1 0 1 1 1 1 1 1 1 1 1 13 13 13
4 4 4 1 1 0 1 1 1 12 12 11 0 4 1 13 1 1 1 1 1 1 4 5 5 1 4 1 1 1 1 1 1 1 1 1 1 1 1 1 1 1 1 1 1 1 1 13 13 13
4 4 4 1 1 1 1 4 13 1 1 1 1 1 1 1 1 1 1 1 1 1 4 5 5 1 1 1 1 1 1 1 1 1 1 1 1 1 1 1 1 1 1 1 1 1 1 13 13 13
4 13 4 1 1 1 1 1 1 1 1 1 0 1 1 1 1 4 4 4 4 4 1 5 5 1 1 1 1 1 1 1 1 1 1 1 1 1 1 1 1 1 1 1 1 1 0 13 13 13
4 4 4 1 1 1 1 1 1 1 1 1 1 1 1 1 1 1 1 1 4 1 1 5 5 5 5 5 5 5 5 5 5 5 5 1 1 1 1 1 1 1 1 1 1 1 1 13 13 13
4 4 4 1 1 1 1 1 1 1 1 1 1 1 1 1 1 1 1 4 4 1 1 5 5 5 5 5 5 5 5 5 5 5 5 1 1 1 1 1 1 0 1 1 1 1 1 4 4 13
13 4 4 1 1 1 1 1 1 1 1 1 1 1 1 1 1 1 1 4 1 1 0 1 1 1 1 1 1 1 1 1 1 5 5 1 1 1 1 1 1 1 1 1 1 1 1 13 4 4
4 4 4 1 1 1 1 1 1 1 1 1 1 1 1 1 1 1 1 1 1 1 1 1 1 1 1 1 1 1 1 1 1 5 5 1 1 1 1 1 1 1 1 1 1 1 1 13 4 4
4 4 4 1 1 1 1 1 1 1 1 1 1 1 1 1 1 1 1 1 1 1 1 1 1 1 1 1 0 1 1 1 1 5 5 1 1 1 1 1 1 1 1 1 1 1 1 13 4 4
4 4 4 1 1 1 1 1 1 1 1 1 1 1 1 1 1 1 1 1 1 1 1 1 1 0 1 1 1 1 1 1 1 5 5 1 1 1 1 1 1 1 1 1 1 1 1 13 13 13
4 4 13 4 1 1 0 1 1 1 1 1 1 1 1 1 1 0 1 1 1 1 1 1 1 1 1 1 1 1 1 1 1 5 5 1 1 1 1 1 1 1 1 1 1 1 1 4 13 4
4 4 4 4 1 1 1 1 1 1 1 1 1 1 1 1 1 1 1 1 1 1 1 1 1 1 1 1 1 1 1 1 1 5 5 1 1 1 1 1 1 1 1 1 1 1 1 13 4 13
4 4 4 4 4 13 13 13 13 13 13 13 13 4 4 4 4 4 4 13 13 13 13 13 13 13 13 13 1 3 1 1 1 5 5 1 1 1 3 4 13 13 4 13 13 13 0 13 13 13
4 13 4 4 4 4 4 4 4 4 4 4 4 4 4 4 4 4 4 13 4 13 4 4 4 4 0 13 13 3 1 1 1 5 5 1 1 1 3 13 13 13 4 13 13 13 13 13 4 13
13 4 4 4 13 4 4 4 4 4 4 4 4 4 4 4 4 13 4 4 1 13 13 13 13 13 13 13 4 7 12 12 12 12 12 12 12 12 11 13 13 13 13 4 4 4 4 13 13 13
