4 4 4 4 4 4 4 4 13 4 4 2 2 2 2 2 4 4 4 13 13 13 13 13 13 13 13 13 13 13 13 13 13 13 13 13 13 13 13 13 13 13 13 13 13 13 13 13 13 13 13 13 13 13 13 13 13 13 13 13 13 13 13 13 13 13 13 13 13 13 13 13 13 13 13 13 13 13 13 13 13 13 13 13 13 13 13 13 13 13 13 13 13 13 13 13 13 13 13 13
4 4 4 4 4 4 13 4 4 13 4 2 2 2 2 4 4 4 13 13 13 13 13 13 13 13 13 13 13 13 13 13 13 13 13 13 13 13 13 13 13 13 13 13 13 13 13 13 13 13 13 13 13 13 13 13 13 13 13 13 13 13 13 13 13 13 13 13 13 13 13 13 13 13 13 13 13 13 13 13 13 13 13 13 13 13 13 13 13 13 13 13 13 13 13 13 13 13 13 13
4 4 13 13 4 4 4 4 4 4 4 2 2 2 2 4 4 4 4 13 13 13 13 13 13 13 13 13 13 13 13 13 13 13 13 13 13 13 13 13 13 13 13 13 13 13 13 13 13 13 13 13 13 13 13 13 13 13 13 13 13 13 13 13 13 13 13 13 13 13 13 13 13 13 13 13 13 13 13 13 13 13 13 13 13 4 4 4 13 13 13 13 13 13 13 13 13 13 13 13
4 13 4 4 13 4 4 4 4 4 2 2 2 2 2 4 4 4 4 4 4 4 4 4 4 4 4 4 4 4 4 4 4 13 13 13 13 13 13 13 13 13 13 4 4 4 4 13 13 13 13 13 13 13 13 13 13 13 13 13 13 13 13 13 13 13 13 13 13 13 13 13 13 13 13 4 4 4 4 4 4 4 4 4 4 4 4 4 4 4 4 4 4 4 13 13 13 13 13 13
4 4 4 4 4 4 4 4 4 4 2 2 2 2 2 4 4 4 4 4 4 4 4 4 4 4 13 13 13 13 13 13 13 13 13 13 13 13 13 13 13 13 13 13 13 4 4 4 4 4 4 4 4 4 4 4 4 4 4 4 4 4 4 4 4 4 4 4 4 4 4 4 4 4 4 4 4 4 4 4 4 4 4 4 4 4 4 4 4 4 4 4 4 13 13 13 13 13 13 13
4 4 4 4 4 4 4 4 4 2 2 2 2 2 4 4 4 4 13 13 13 13 13 13 13 13 13 13 13 13 13 13 13 13 13 13 13 13 13 13 13 13 4 4 4 4 4 4 13 13 13 13 13 4 4 4 4 4 4 4 13 13 13 4 4 4 4 4 4 4 4 4 4 4 13 13 13 13 13 13 13 13 13 13 13 13 13 13 13 13 13 13 13 13 13 13 13 13 13 13
4 4 4 4 13 4 4 4 4 2 2 2 2 4 4 4 4 13 13 13 13 13 13 13 13 13 13 13 13 13 13 13 13 13 13 13 13 13 13 13 13 13 13 13 13 13 4 4 13 4 4 4 4 13 13 4 4 4 4 4 4 4 4 13 13 13 13 13 13 4 4 4 4 4 4 13 13 13 13 13 13 13 4 4 13 4 4 4 4 4 4 13 13 13 13 13 13 13 13 13
4 13 4 4 4 4 4 4 2 2 2 2 2 4 4 4 4 13 13 13 13 13 13 13 13 13 13 13 13 13 13 13 13 13 0 13 13 13 13 13 13 13 13 13 13 13 13 13 4 4 4 4 4 4 4 4 4 4 4 4 4 4 4 4 4 4 4 4 4 13 13 4 4 13 13 13 13 13 13 13 13 13 13 4 13 4 4 4 4 4 4 13 13 13 13 13 13 13 13 13
4 4 4 4 4 4 4 2 2 2 2 2 13 4 4 4 1 1 1 1 1 1 1 1 1 1 1 1 1 1 1 1 1 0 1 1 1 1 1 1 1 1 1 2 2 2 4 13 1 1 1 4 4 4 4 4 4 4 4 1 1 1 2 2 2 2 2 1 1 1 13 1 1 1 1 1 1 1 1 1 1 1 1 13 13 1 1 1 4 1 4 1 13 13 13 13 13 13 13 13
4 4 4 4 4 4 2 2 2 2 2 4 4 4 4 1 1 1 1 1 1 1 1 1 1 1 1 1 1 1 1 1 1 1 1 1 1 1 1 1 1 1 1 2 2 2 2 2 1 1 1 1 1 1 1 1 1 1 1 1 1 1 2 2 2 2 2 1 1 1 1 1 1 1 1 1 1 1 1 1 1 1 1 1 1 1 1 1 1 1 4 13 1 13 13 13 13 13 13 13
4 4 4 4 2 2 2 2 2 2 2 4 13 4 1 1 1 1 1 1 1 1 1 1 1 1 1 1 1 1 1 1 1 1 1 1 1 1 1 1 1 1 1 2 2 2 2 2 2 2 1 5 1 5 1 5 1 1 1 1 2 2 2 2 2 2 2 1 1 1 1 1 1 1 1 1 1 1 1 1 1 1 1 1 1 1 1 1 1 13 4 4 4 4 4 13 13 13 13 13
4 4 4 2 2 2 2 2 2 2 4 4 4 4 1 1 1 1 1 1 1 1 1 1 1 1 1 1 1 1 1 1 1 1 1 1 1 1 1 1 1 1 1 1 2 2 2 2 2 2 2 2 2 1 5 1 1 1 1 2 2 2 2 2 2 2 1 1 1 1 1 1 1 1 1 1 1 1 1 1 1 1 1 1 1 1 1 1 1 4 4 4 4 13 4 13 13 13 13 13
4 4 2 2 2 2 2 2 2 2 4 4 4 1 1 1 1 1 1 1 1 1 1 1 1 1 1 1 1 1 1 1 1 1 1 1 1 1 1 1 1 1 1 1 1 2 2 2 2 2 2 2 2 2 2 2 2 2 2 2 2 2 2 2 2 1 1 1 1 1 1 1 1 1 1 1 1 1 1 1 1 1 1 1 1 1 1 1 1 4 4 1 4 4 4 4 13 13 13 13
2 2 2 2 2 2 2 2 2 4 13 4 4 1 1 1 1 1 1 1 1 1 1 1 1 1 0 1 1 1 1 1 0 1 1 1 1 1 0 1 1 1 1 1 1 1 2 2 2 2 2 2 2 2 2 2 2 2 2 2 2 2 2 2 1 1 1 1 1 1 1 1 1 1 1 1 1 1 1 1 1 1 1 1 1 1 1 4 4 4 1 1 4 4 4 4 13 13 13 13
2 2 2 2 2 2 2 2 4 4 4 4 1 1 1 1 1 1 0 1 1 1 1 1 1 1 1 1 1 1 1 1 1 1 1 1 1 1 1 1 1 1 1 1 1 1 1 1 2 2 2 2 2 2 2 2 2 2 2 2 2 2 2 1 0 1 1 1 1 0 1 1 1 1 1 1 1 1 1 1 1 1 1 1 1 1 1 4 4 4 4 1 4 4 4 4 4 4 13 13
2 2 2 2 2 2 4 4 4 4 4 4 1 1 1 1 1 1 1 1 1 1 1 1 1 1 1 1 1 1 1 1 1 1 1 1 1 1 1 1 1 1 1 1 1 1 1 1 1 1 2 2 2 2 2 2 2 2 2 2 2 2 1 1 1 1 1 1 1 1 1 1 1 1 1 1 1 1 1 1 1 1 1 1 1 1 1 4 4 4 4 1 1 4 4 4 4 4 13 13
2 2 2 2 2 4 4 4 4 4 4 1 1 1 1 1 1 1 1 1 1 1 1 1 1 1 1 1 1 1 1 1 1 1 1 1 1 1 1 1 1 1 1 1 1 1 1 1 1 1 1 1 1 1 1 1 1 1 1 1 1 1 1 1 1 1 1 1 1 1 1 1 1 1 0 1 1 1 1 1 1 1 1 1 1 1 1 1 4 1 1 4 1 1 4 4 4 4 13 13
2 2 2 2 4 4 13 4 4 1 1 1 1 1 1 1 1 1 1 1 1 1 1 0 1 1 1 1 1 1 1 1 1 1 1 1 1 1 1 1 1 1 1 1 1 1 1 1 1 1 1 1 1 1 1 1 1 1 1 1 1 1 1 1 1 1 1 1 1 1 1 1 1 1 1 1 1 1 0 1 1 1 1 1 1 1 1 1 4 1 1 4 1 1 4 4 4 4 13 13
2 2 13 4 4 4 13 4 4 1 1 1 1 1 1 1 1 1 1 1 1 1 1 1 1 1 1 1 1 1 1 1 1 1 1 1 1 1 1 1 1 1 1 1 1 1 1 1 1 1 1 5 1 1 1 1 1 1 1 1 1 1 1 1 1 1 1 1 1 1 1 1 1 1 1 1 1 1 0 1 1 1 1 1 1 1 1 1 4 1 1 1 4 1 1 4 4 4 13 13
13 13 13 4 4 4 13 4 4 1 1 1 1 1 1 1 1 1 1 1 1 1 1 1 1 1 1 1 1 1 1 1 1 1 1 1 1 1 1 1 1 1 0 1 1 1 1 1 1 1 1 1 1 1 1 1 1 1 1 1 1 1 1 1 1 1 1 1 1 0 1 1 1 1 1 1 1 1 1 1 1 1 1 1 1 1 1 1 4 4 1 1 4 1 1 4 4 4 13 13
13 13 13 4 4 13 4 4 4 1 1 1 1 1 1 1 1 1 1 0 1 1 1 1 1 1 1 1 1 1 1 1 1 1 1 1 1 1 1 1 1 1 1 1 1 1 1 1 1 1 1 1 1 5 1 1 1 1 1 1 1 1 1 1 1 1 1 1 1 1 1 1 1 1 1 1 1 1 1 0 1 1 1 1 1 1 1 1 1 4 1 1 4 1 1 4 4 4 13 13
13 13 13 4 4 13 4 4 4 1 1 1 0 1 1 1 1 1 1 0 1 1 1 1 1 1 1 1 1 1 1 0 1 1 1 1 1 1 1 1 1 1 1 1 1 1 1 1 1 1 1 1 1 1 1 1 1 1 1 1 1 1 1 1 1 1 1 0 1 1 1 1 1 1 1 1 1 1 1 1 1 1 1 1 1 1 1 1 1 1 1 1 1 4 1 4 4 4 13 13
13 13 13 4 4 13 4 4 4 1 1 1 1 1 1 1 1 1 1 0 1 1 1 1 1 0 1 1 1 1 1 1 1 1 1 1 1 1 1 1 1 1 1 1 1 1 1 1 0 1 1 1 1 1 1 1 1 1 0 1 1 1 1 1 1 1 1 1 1 1 1 1 1 1 1 0 1 1 1 0 1 1 1 1 1 1 1 1 1 1 1 1 1 4 1 4 4 4 13 13
13 13 13 4 4 13 4 4 4 1 1 1 1 1 1 0 1 0 0 1 1 1 0 1 1 1 1 1 1 1 1 1 1 1 1 1 1 1 1 1 1 1 1 1 1 1 1 1 1 1 1 0 1 1 1 1 1 1 1 1 1 1 1 1 1 1 1 1 1 1 1 1 1 1 1 1 1 1 1 1 1 1 1 1 1 1 1 1 1 1 1 1 1 4 1 4 4 4 13 13
13 13 13 4 4 13 4 4 4 1 1 1 1 1 1 1 1 1 0 1 1 1 1 1 1 1 1 1 1 1 1 1 1 1 1 0 1 1 1 1 1 1 1 1 1 1 1 1 1 1 1 1 1 1 1 1 1 1 1 1 1 1 1 0 1 1 1 1 1 1 1 1 1 1 1 1 1 1 0 1 1 1 1 0 1 1 1 1 1 0 1 1 1 4 1 4 4 4 13 13
13 13 13 4 4 13 4 4 4 1 1 1 1 1 1 1 1 1 0 1 1 1 1 1 1 1 1 1 1 1 1 1 1 1 1 1 1 1 1 0 0 1 1 1 1 1 1 1 1 1 1 1 1 1 1 1 1 1 1 0 1 1 1 1 1 0 1 1 1 1 1 1 1 1 1 1 1 1 1 1 1 1 1 1 1 1 1 1 1 1 1 1 1 1 4 4 4 4 13 13
13 13 13 4 4 13 4 4 4 1 1 1 1 1 1 1 1 0 1 1 1 1 1 1 1 1 1 1 1 1 1 1 1 1 1 0 1 1 1 1 1 1 1 1 1 1 1 1 1 1 1 1 1 1 5 1 1 1 1 1 1 1 1 1 1 1 1 1 1 1 1 1 1 1 1 1 1 1 1 1 1 1 1 1 1 1 1 1 1 1 1 1 1 1 4 4 4 4 13 13
13 13 13 4 4 13 4 4 4 1 1 1 1 1 1 1 1 0 1 1 1 1 1 1 1 1 1 13 13 1 1 1 1 1 1 1 1 1 1 1 1 1 1 1 1 1 1 1 1 1 1 1 1 1 1 1 1 1 1 1 1 1 1 1 1 1 1 1 1 1 1 1 1 1 1 1 1 1 1 1 0 1 1 1 1 1 1 1 1 1 1 1 1 1 4 4 4 4 13 13
13 13 13 4 4 4 4 4 4 1 1 1 1 1 1 1 1 0 1 1 1 1 1 1 1 1 13 13 13 1 1 1 1 1 1 1 1 1 1 1 1 1 1 1 1 1 1 1 0 1 1 1 1 1 1 1 1 1 1 1 1 1 1 1 1 1 1 1 1 1 1 1 1 1 1 1 1 1 1 1 1 1 1 1 1 1 1 1 1 1 1 1 1 1 1 4 4 4 13 13
13 13 13 4 4 4 4 4 4 1 1 1 1 1 1 1 1 0 1 1 1 1 1 1 1 13 13 1 13 1 1 1 1 1 1 1 1 1 1 1 1 1 1 1 1 1 1 1 1 1 1 5 5 1 1 1 1 1 1 1 1 1 1 1 1 1 1 1 1 1 1 1 1 1 1 1 1 1 1 1 1 1 1 1 1 1 1 1 1 1 1 1 1 1 1 4 4 4 13 13
13 13 13 4 4 4 4 4 4 1 1 1 1 1 1 1 0 1 1 0 1 1 1 1 1 13 1 13 13 1 1 1 1 1 1 1 1 1 1 1 1 1 1 1 1 1 1 1 1 1 1 13 13 13 13 13 13 13 13 13 13 13 1 1 1 1 1 0 1 1 1 1 1 13 1 1 1 1 1 1 1 0 1 1 1 1 1 1 0 1 1 1 1 1 1 4 4 4 13 13
13 13 13 4 4 4 4 4 4 1 1 1 1 1 1 1 0 1 1 1 1 1 1 1 13 1 13 13 1 1 1 1 1 1 1 1 1 1 1 1 1 1 1 13 1 1 1 1 1 1 1 1 13 13 13 13 13 13 13 13 13 13 13 13 0 1 1 1 1 13 13 13 13 13 13 1 1 1 1 1 1 1 1 1 1 1 1 1 1 1 1 1 1 1 4 4 4 4 13 13
13 13 13 4 4 4 4 4 4 1 1 1 1 1 1 1 1 1 1 1 1 1 1 13 1 1 13 1 1 1 1 1 1 0 1 1 1 1 1 1 1 1 1 1 1 1 1 1 1 1 5 1 1 1 1 1 1 1 1 1 1 1 1 1 13 1 1 1 1 1 1 1 1 13 13 13 13 13 1 1 1 1 1 1 1 1 1 1 1 1 1 1 1 1 4 4 4 4 13 13
13 13 13 4 4 4 4 4 4 1 1 0 1 1 1 1 1 1 1 1 1 1 1 13 4 4 13 1 1 1 1 1 1 1 1 1 1 1 1 1 0 1 13 1 1 1 1 1 1 1 1 1 4 4 4 4 1 1 1 1 0 1 1 1 1 13 1 1 1 1 1 1 0 1 13 13 13 13 13 1 1 1 1 1 1 0 1 1 1 1 1 1 1 1 4 13 4 4 13 13
13 13 13 4 4 4 4 4 4 1 1 1 1 1 1 1 1 1 1 1 1 1 1 13 4 4 1 1 1 1 1 1 1 1 1 1 1 1 1 1 1 1 1 1 1 1 1 1 4 4 4 4 1 5 1 4 4 1 1 1 1 1 1 1 1 1 1 1 1 1 1 1 1 1 1 13 1 13 13 13 13 1 1 1 1 1 1 1 1 1 1 1 1 1 4 4 4 4 13 13
13 13 13 4 4 4 4 4 4 1 1 1 0 1 1 1 1 1 1 1 1 1 1 1 4 1 1 1 1 1 1 1 0 1 1 1 1 1 1 1 1 1 1 1 1 1 1 1 1 1 1 5 5 1 1 1 1 1 1 1 1 1 1 4 4 4 4 1 1 1 1 1 1 1 1 1 1 1 13 13 13 13 1 1 1 1 1 1 1 1 1 1 4 4 4 4 4 4 13 13
13 13 13 4 4 4 4 4 4 1 1 1 1 1 1 1 1 1 1 1 1 1 1 1 4 0 1 1 1 1 1 1 1 1 1 1 1 1 1 1 1 1 1 1 0 1 1 1 1 1 1 1 1 1 1 1 1 1 1 1 1 1 1 1 1 1 4 1 1 4 1 1 1 1 1 1 1 1 1 13 13 13 13 1 1 1 1 1 1 1 1 1 1 1 13 4 4 4 13 13
13 13 13 4 4 4 4 4 4 1 1 1 1 1 1 1 1 1 1 1 1 1 1 1 1 1 1 1 1 1 1 1 1 1 1 1 1 1 4 1 1 1 1 1 1 0 1 1 1 1 1 1 1 1 1 1 1 1 1 1 1 1 1 1 1 1 1 4 1 1 1 4 4 1 1 1 1 1 1 1 13 13 13 13 1 1 1 1 1 1 1 1 1 1 4 4 4 13 13 13
13 13 13 4 4 4 4 4 4 1 1 1 1 1 1 1 1 1 1 1 1 1 1 1 1 1 1 1 1 1 1 1 1 1 1 1 4 4 4 1 1 1 1 1 1 1 1 1 1 1 1 1 1 1 1 1 1 1 1 1 0 1 1 1 1 1 1 4 1 1 1 1 4 1 1 1 1 1 1 1 1 13 1 13 13 1 1 1 1 1 1 1 1 1 4 4 4 13 13 13
13 13 13 4 4 4 4 4 4 1 1 1 1 1 1 1 1 1 0 1 1 0 1 1 1 1 1 1 1 1 1 1 1 1 1 4 4 1 1 1 1 1 0 1 1 1 1 1 1 1 4 0 5 5 0 4 1 1 1 1 1 1 1 0 1 1 1 1 4 1 1 1 4 4 4 4 1 1 1 1 13 1 13 13 13 13 1 1 1 1 1 1 1 13 13 4 4 13 13 13
13 13 13 4 4 4 4 4 4 1 1 1 1 1 1 1 1 1 1 1 1 1 1 1 1 1 1 1 1 1 1 1 13 1 1 4 1 0 1 1 1 1 1 1 1 1 1 1 1 13 0 5 5 5 5 0 13 1 1 1 1 1 1 1 1 1 1 1 4 1 1 4 4 1 1 1 1 1 1 1 1 1 1 1 1 1 1 1 1 1 1 1 13 13 13 4 4 13 13 13
13 13 13 4 4 4 13 4 4 1 1 1 1 1 1 1 1 1 1 1 1 1 1 1 1 1 1 1 1 1 1 1 1 1 1 4 1 1 1 1 1 1 1 1 1 1 1 2 2 2 2 5 5 5 5 2 2 2 2 1 1 1 1 1 1 1 1 1 4 1 4 4 1 1 1 1 1 1 1 1 1 1 1 1 1 1 1 1 1 1 1 1 13 13 13 4 4 13 13 13
13 13 13 4 4 4 13 4 4 1 1 1 1 1 1 0 1 0 1 1 1 1 1 1 1 0 1 1 1 1 1 1 1 1 1 4 1 1 1 1 1 1 1 1 1 2 2 2 2 2 2 5 5 5 5 2 2 2 2 2 2 1 1 1 0 1 1 1 4 1 4 1 1 1 1 1 1 1 1 1 1 1 1 1 1 1 1 1 1 1 1 1 13 13 13 4 4 13 13 13
13 13 13 4 4 4 13 4 4 1 1 1 1 1 1 1 1 1 1 1 1 1 1 1 1 1 1 1 1 1 1 1 1 1 1 1 1 1 1 1 1 1 1 1 2 2 2 2 2 2 2 5 5 5 5 2 2 2 2 2 2 2 1 1 1 1 1 1 4 1 1 1 1 1 1 4 1 1 1 1 1 1 1 1 1 1 1 1 1 1 1 1 13 13 13 4 4 13 13 13
13 13 13 4 4 4 13 4 4 1 1 1 1 1 1 1 1 1 1 1 1 13 1 1 1 1 1 1 1 1 1 1 1 1 1 1 4 4 4 1 1 1 1 2 2 2 2 2 6 10 10 1 1 1 1 10 10 8 2 2 2 2 2 1 1 1 1 1 1 4 1 1 1 1 1 1 1 1 1 1 1 1 1 1 1 1 1 1 1 1 1 1 13 13 13 4 4 13 13 13
13 13 13 4 4 4 13 4 4 1 1 1 1 1 1 1 1 1 1 1 1 1 1 1 1 1 1 1 1 1 1 1 1 1 1 1 1 1 1 1 1 1 2 2 2 2 6 10 9 1 1 1 1 1 1 1 1 7 10 8 2 2 2 2 1 1 1 1 1 0 1 1 1 1 1 1 1 1 1 1 1 1 1 1 1 1 1 1 1 1 1 1 1 13 13 4 4 13 13 13
13 13 13 4 4 4 13 13 1 1 1 1 1 1 1 1 1 1 1 1 1 1 1 1 1 1 1 1 1 1 4 1 0 1 1 1 1 1 1 1 1 1 2 2 2 6 9 1 1 1 1 1 1 0 1 0 1 1 1 7 8 2 2 2 1 1 1 1 1 1 1 1 1 1 1 1 1 1 1 0 1 1 1 1 1 1 1 1 1 1 1 1 1 13 13 4 4 13 13 13
4 4 4 4 4 13 13 13 1 1 1 1 1 1 1 1 1 1 1 1 1 1 1 1 1 1 1 1 1 1 4 1 1 1 1 1 1 1 1 1 1 2 2 2 6 9 1 1 1 1 0 0 0 1 1 1 1 1 1 1 7 8 2 2 2 1 1 1 1 0 1 1 1 1 1 1 1 1 1 1 1 1 1 1 1 0 1 1 1 1 1 1 1 13 13 4 4 13 13 13
4 4 4 4 4 13 13 13 1 1 1 1 1 1 1 0 1 1 1 0 1 1 1 1 1 1 1 1 1 1 4 1 1 1 1 0 1 1 1 4 13 2 2 2 3 1 1 1 1 1 0 1 1 14 4 1 0 0 1 1 1 3 2 2 2 13 4 1 1 1 1 1 1 0 1 1 4 1 1 4 1 1 1 1 1 1 1 1 1 1 1 1 1 13 13 4 4 13 13 13
4 13 4 4 4 13 13 13 1 1 1 1 1 1 1 1 1 1 1 1 1 1 1 1 1 13 1 5 1 1 1 1 1 5 1 1 1 1 1 0 2 2 2 2 3 1 1 1 1 1 1 14 4 14 13 14 1 0 1 1 1 7 2 2 2 2 0 1 1 1 1 1 1 1 1 1 1 1 1 1 1 1 1 1 1 1 1 13 1 1 1 1 1 13 13 4 4 13 13 13
5 5 5 5 5 5 5 5 5 5 5 5 5 1 1 1 5 1 1 1 1 1 1 5 1 5 1 1 1 5 1 1 1 5 1 1 1 1 0 5 5 5 5 1 1 1 1 1 1 1 0 13 14 13 14 4 14 0 1 1 1 1 1 5 5 5 5 0 1 0 1 1 1 1 1 1 1 1 0 1 1 1 4 1 1 1 1 1 1 1 13 1 1 5 5 5 5 5 5 5
13 5 5 5 4 4 13 13 1 1 1 1 1 0 1 1 1 1 5 5 1 1 1 1 1 1 1 5 1 1 1 1 1 1 1 1 5 1 5 5 5 5 5 1 1 1 1 1 0 1 14 4 14 14 13 14 4 0 0 1 1 1 1 5 5 5 5 5 1 1 5 1 1 13 1 1 5 1 1 1 1 5 1 1 1 1 1 1 5 1 1 1 1 5 5 5 5 5 5 5
5 13 13 5 5 5 13 5 1 5 1 1 5 1 1 1 1 1 1 1 1 5 1 13 1 1 1 0 1 5 1 1 1 5 1 5 1 1 5 5 5 5 5 1 1 1 1 1 0 1 13 14 14 14 14 4 14 0 0 1 1 1 1 5 5 5 5 5 1 1 5 5 5 1 5 1 1 1 1 1 5 1 5 1 1 5 1 1 1 1 1 1 1 5 5 5 5 5 5 5
13 13 13 4 4 5 5 5 1 1 1 1 1 0 1 0 1 1 1 1 1 1 1 1 1 1 1 0 1 1 1 13 1 1 1 0 1 1 0 5 5 5 5 1 1 1 1 1 0 0 14 14 4 13 14 14 1 1 1 1 1 1 1 5 5 5 5 0 1 1 1 1 1 1 1 1 5 1 1 5 1 1 1 1 1 1 1 1 1 5 1 1 1 5 5 5 5 5 5 5
13 13 13 4 4 4 13 13 1 1 1 1 1 1 1 1 1 1 1 1 4 4 4 4 1 1 1 1 1 1 1 1 1 1 1 1 1 1 1 0 2 2 2 2 3 1 1 1 1 0 1 1 4 14 1 1 1 0 1 1 1 3 2 2 2 2 0 1 1 1 1 1 1 1 1 1 1 1 1 13 1 1 1 1 4 1 1 1 1 1 1 1 1 5 5 5 5 5 5 5
13 13 13 4 4 4 13 13 1 1 1 1 1 1 1 1 1 1 1 1 1 1 13 4 1 1 1 1 1 1 1 1 1 1 1 1 1 1 1 4 13 2 2 2 3 1 1 1 1 1 1 1 0 1 0 1 1 1 1 1 1 3 2 2 2 13 4 1 1 1 1 1 1 1 1 1 1 1 1 1 1 1 1 1 1 1 1 0 0 1 1 1 1 13 13 4 4 13 13 13
13 13 13 4 4 4 13 13 1 1 1 1 1 1 1 1 1 1 1 1 1 1 13 4 1 1 1 1 1 1 1 1 1 1 1 1 1 1 1 1 1 2 2 2 7 8 1 1 1 1 1 1 1 0 1 1 0 1 1 1 6 9 2 2 2 1 1 1 1 1 1 1 1 1 1 1 1 0 13 1 1 1 1 1 1 1 1 1 1 1 1 1 1 13 13 4 4 13 13 13
13 13 13 4 4 4 13 13 1 1 1 1 1 1 1 1 1 1 1 1 1 1 13 1 1 1 1 0 1 4 4 4 4 1 1 1 1 1 1 1 1 1 2 2 2 7 8 1 1 1 1 1 1 1 1 1 1 1 1 6 9 2 2 2 1 1 1 1 1 1 1 1 1 1 1 4 1 1 1 1 1 1 1 1 1 1 1 0 1 1 1 1 1 13 4 4 4 13 13 13
13 13 13 4 4 4 13 13 1 1 1 1 1 0 0 1 1 1 1 1 1 1 13 1 1 1 1 1 1 4 1 4 1 1 1 1 1 1 1 1 1 1 2 2 2 2 7 10 8 1 1 1 1 1 1 1 1 6 10 9 2 2 2 2 1 1 1 1 1 1 1 4 0 1 1 4 1 1 1 1 1 1 1 1 1 1 1 1 1 1 1 1 1 13 4 4 4 4 13 13
13 13 13 4 4 4 13 13 1 1 1 1 1 1 1 0 1 1 1 1 1 1 13 13 1 1 1 1 1 4 4 4 1 1 1 0 1 1 1 1 1 1 1 2 2 2 2 2 7 10 10 1 1 1 1 10 10 9 2 2 2 2 2 1 1 1 1 1 1 1 1 4 1 1 1 4 1 1 1 1 1 1 1 1 1 1 1 1 1 1 1 1 1 13 4 4 4 4 13 13
13 13 13 4 4 4 13 13 1 1 1 1 1 1 1 1 1 1 1 1 1 1 13 1 1 1 1 1 1 4 4 4 1 1 1 1 1 1 1 1 1 1 1 2 2 2 2 2 2 2 2 5 5 5 5 2 2 2 2 2 2 2 1 1 1 1 1 1 4 4 4 4 1 1 1 4 4 1 1 1 1 1 1 1 1 1 1 1 1 1 1 1 1 13 4 4 4 4 13 13
13 13 13 4 4 4 13 13 1 1 1 1 0 1 1 0 1 1 1 1 1 1 1 1 1 1 1 1 1 4 4 4 1 1 1 1 1 1 1 1 1 1 1 1 1 2 2 2 2 2 2 5 5 5 5 2 2 2 2 2 2 1 1 1 1 1 1 1 4 1 1 1 1 1 1 1 4 1 1 1 1 1 1 1 1 1 1 1 1 1 1 1 1 13 4 4 4 4 13 13
13 13 13 4 4 4 13 13 1 1 1 1 1 1 1 0 1 1 1 1 1 1 1 1 1 1 1 1 1 4 4 1 1 1 1 1 1 1 1 1 1 1 1 1 1 1 1 2 2 2 2 5 5 5 5 2 2 2 2 1 1 1 1 1 1 1 1 4 1 1 1 1 0 1 1 1 4 4 1 1 1 1 1 1 1 1 1 1 1 1 1 1 1 13 4 4 4 4 13 13
13 13 13 4 4 4 13 13 1 1 1 1 1 1 1 1 1 1 1 1 1 1 1 1 1 1 1 4 4 4 1 4 1 0 1 1 4 1 1 1 1 1 1 1 1 1 1 1 1 1 13 5 5 5 5 13 1 1 1 1 1 1 1 1 1 1 1 1 1 1 1 1 1 1 1 1 1 4 1 1 1 1 0 0 1 1 1 1 1 1 1 1 1 13 4 4 4 4 13 13
13 13 13 4 4 4 13 13 1 1 1 1 1 1 1 1 1 1 1 1 1 1 1 1 1 1 1 1 1 1 1 1 1 1 0 1 4 4 1 1 1 1 1 1 1 1 1 1 1 1 4 0 5 5 0 4 1 1 1 1 1 1 1 1 1 1 1 1 1 1 1 1 1 1 1 1 1 1 1 1 1 1 1 1 0 1 1 1 1 1 1 1 1 13 4 1 4 13 13 13
13 13 13 4 4 4 13 13 1 1 1 1 1 0 1 1 1 1 1 1 1 1 1 1 1 1 1 1 1 1 1 1 1 1 1 1 1 4 1 1 1 1 1 1 1 1 1 1 1 1 1 1 1 1 1 1 1 1 1 1 1 1 4 1 1 1 1 1 1 1 1 1 1 1 1 1 1 1 1 1 1 1 1 1 1 1 1 1 1 1 1 1 1 4 4 4 4 13 13 13
13 13 13 4 4 4 13 13 1 1 1 1 1 1 1 1 1 1 1 1 1 1 1 1 1 1 1 1 1 1 1 1 1 1 1 1 1 4 1 1 1 1 1 1 1 4 1 1 1 1 1 1 1 1 1 1 0 1 1 1 1 1 1 1 1 1 1 1 1 1 1 1 13 1 4 1 1 1 13 1 1 1 1 1 1 1 1 1 1 1 1 1 1 4 4 4 13 13 13 13
13 13 13 4 4 4 13 13 1 1 1 1 1 1 1 1 1 1 1 1 1 1 1 1 1 1 1 1 1 1 1 1 1 1 1 1 1 4 1 1 13 1 1 1 1 4 1 1 1 1 1 1 5 1 1 1 1 1 1 0 1 1 1 1 1 1 1 1 1 1 1 1 1 1 1 1 1 1 1 1 1 1 1 1 1 1 1 1 1 1 1 1 1 13 13 4 13 13 13 13
13 13 13 4 4 4 13 13 1 1 1 1 1 1 1 1 1 1 1 1 1 1 1 1 1 1 1 1 1 1 1 1 1 1 1 1 4 4 1 1 1 4 1 1 1 4 0 0 1 1 1 1 1 1 5 1 1 1 1 0 1 1 1 1 1 1 1 1 1 1 1 1 1 1 1 1 1 1 1 1 1 1 1 1 1 1 1 1 1 1 1 1 1 4 13 4 4 13 13 13
13 13 13 4 4 4 13 13 1 1 1 1 1 1 1 1 1 1 1 1 1 1 1 1 1 1 1 1 1 1 1 1 1 1 1 1 1 1 1 1 4 4 1 1 4 4 1 1 1 1 1 1 1 1 1 1 1 1 1 1 1 1 1 1 1 4 4 1 1 1 1 1 1 1 1 1 1 1 1 1 1 1 1 1 1 1 1 1 1 1 1 1 1 1 4 4 4 13 13 13
13 13 13 4 4 4 13 13 1 1 1 1 1 1 1 1 1 1 1 1 1 1 1 1 1 1 1 1 1 1 1 1 1 1 1 1 1 1 4 4 1 1 1 1 1 4 1 1 1 1 4 4 4 4 1 1 1 1 1 1 1 1 1 1 1 1 4 1 1 1 1 1 1 1 1 1 1 1 1 1 1 1 1 1 1 1 1 1 1 1 1 1 1 1 4 4 4 13 13 1
13 13 13 4 4 4 13 13 1 1 1 1 1 1 1 1 1 1 1 1 1 1 1 1 1 1 1 1 1 1 1 1 1 1 1 1 1 4 4 1 1 4 4 1 1 4 1 1 1 1 1 1 1 4 4 1 1 1 1 1 1 1 1 1 4 4 1 1 1 1 1 1 1 1 0 1 1 1 1 0 0 1 1 1 1 1 1 1 1 0 1 1 1 1 4 4 4 4 13 13
13 13 13 4 4 4 13 13 1 1 1 1 1 1 1 1 1 1 1 1 1 1 1 1 1 1 1 1 1 1 1 1 1 1 1 1 1 1 1 1 1 1 1 1 1 4 1 1 1 1 1 1 1 1 4 4 1 1 1 1 1 1 4 4 1 1 1 1 1 1 1 1 1 1 1 1 1 1 1 1 1 1 1 1 1 1 1 1 1 1 1 1 1 1 4 4 4 4 13 13
13 13 13 4 4 4 13 13 1 1 1 1 1 1 1 1 1 1 0 0 0 0 1 1 1 1 1 1 1 1 1 1 1 1 1 1 1 1 1 1 1 1 1 1 1 1 1 1 1 1 1 1 1 1 1 1 1 1 1 1 1 1 4 1 1 1 1 1 1 1 1 1 1 1 1 1 1 1 1 1 1 1 1 1 1 1 1 1 1 1 1 1 1 4 4 4 4 4 13 13
13 13 13 4 4 4 13 13 1 1 1 1 1 1 1 1 1 1 1 1 1 0 1 0 1 1 1 1 1 1 1 1 1 1 1 1 1 1 1 1 1 1 1 1 1 1 1 1 1 1 1 1 1 1 0 1 1 1 1 1 1 1 1 1 1 1 1 1 1 1 1 1 1 1 1 1 1 1 1 1 1 1 1 1 1 1 1 1 0 1 1 1 1 4 4 4 4 4 13 13
13 13 13 4 4 4 13 13 1 1 1 1 1 1 1 1 1 1 1 0 0 0 0 0 0 0 0 0 1 1 1 1 1 1 1 1 1 1 1 1 1 1 1 1 1 1 1 1 1 1 1 1 5 1 1 1 1 1 1 1 1 1 1 1 1 1 1 1 1 1 1 1 1 1 1 1 1 1 0 1 1 1 1 1 1 0 1 0 1 1 1 1 1 4 4 4 4 4 13 13
13 13 13 4 4 4 13 13 1 1 1 1 1 1 1 1 1 1 0 0 0 0 1 1 1 1 1 0 0 0 0 0 0 1 1 1 1 1 0 0 0 0 0 1 1 1 1 1 1 1 1 1 5 5 1 1 1 1 1 1 1 1 1 1 1 1 1 1 1 1 1 1 1 1 1 1 1 1 1 1 1 1 1 1 1 0 1 1 0 1 1 1 1 4 4 4 4 4 13 13
13 13 13 4 4 4 13 13 1 1 1 1 1 1 1 1 1 1 0 1 1 1 1 1 1 1 1 1 1 1 1 1 0 1 1 1 1 1 1 1 1 1 0 0 1 1 1 1 1 1 1 1 5 1 1 1 1 1 1 1 1 1 1 1 1 0 1 1 1 1 1 1 1 1 1 1 1 1 1 1 1 1 1 1 1 0 1 0 1 1 1 1 1 4 4 4 4 13 13 13
13 13 13 4 4 4 13 13 1 1 1 1 1 1 1 1 1 0 0 0 0 0 0 0 0 0 0 0 1 1 1 1 1 1 1 1 1 1 1 1 1 1 1 1 1 1 1 1 1 1 1 0 1 1 1 1 1 1 1 1 1 1 1 1 1 1 1 1 1 1 1 1 1 1 0 1 1 1 1 1 1 1 1 1 1 1 1 1 1 1 1 1 1 4 4 4 4 13 13 13
13 13 13 4 4 4 13 13 1 1 1 1 1 1 1 1 1 0 1 1 1 1 1 1 1 1 1 1 1 1 1 1 1 1 1 1 1 1 1 1 1 1 1 1 1 1 1 1 1 1 1 1 1 0 1 1 1 1 1 1 1 1 1 1 1 1 1 1 1 1 1 1 1 1 1 1 1 1 1 1 1 1 1 1 1 1 1 1 1 1 1 1 1 1 4 4 4 13 13 13
13 13 13 4 4 4 13 13 1 1 1 1 1 1 1 1 0 1 1 1 1 0 0 1 1 1 1 1 1 1 1 1 1 1 1 1 1 1 1 1 1 1 1 1 1 1 1 1 1 1 1 1 1 1 1 1 1 1 1 1 1 1 1 1 1 1 1 1 1 1 1 1 1 1 1 1 1 1 1 1 1 1 1 1 1 1 1 1 1 1 1 1 1 1 4 4 4 13 13 13
13 13 13 4 4 4 13 13 1 1 1 1 1 1 1 1 0 1 1 1 1 0 0 0 1 1 1 1 1 1 1 1 1 1 1 1 1 1 1 1 1 1 1 1 1 1 1 1 1 5 1 5 1 5 1 1 1 1 1 1 1 1 1 1 1 1 1 1 1 1 0 1 1 1 1 1 1 1 1 1 1 0 1 1 1 1 1 1 1 1 1 1 1 0 4 4 13 13 13 13
13 13 13 13 4 4 13 13 1 1 1 1 1 1 1 1 0 1 1 1 1 0 1 1 0 1 1 1 1 1 1 1 1 1 1 1 1 1 1 1 1 1 1 1 1 1 0 1 1 1 1 1 1 1 5 1 1 1 1 1 1 1 1 1 1 1 1 1 1 1 1 1 1 1 1 1 1 1 1 1 1 1 1 1 1 1 1 1 1 1 1 1 1 1 4 4 13 13 13 13
13 13 13 13 4 4 13 13 1 1 1 1 1 1 1 1 1 1 1 1 1 1 1 1 0 0 0 0 0 1 1 1 1 1 0 1 1 1 1 1 1 1 1 1 1 1 1 1 1 1 1 1 1 1 1 1 1 1 1 1 1 1 1 1 1 1 1 1 1 1 1 1 1 1 1 1 1 1 1 1 0 1 1 1 1 1 1 0 1 1 1 1 1 1 4 4 13 13 13 13
13 13 13 13 13 4 13 13 1 1 1 1 1 1 1 1 1 1 1 1 1 1 1 1 1 1 1 1 1 1 1 1 1 1 1 1 1 1 1 1 1 1 1 1 1 1 1 1 1 1 0 1 5 5 1 1 1 1 1 1 1 1 1 1 1 0 1 1 1 1 1 0 1 1 1 1 1 1 1 1 0 1 1 1 1 1 1 1 1 1 1 1 1 0 4 4 13 13 13 13
13 13 13 13 4 4 13 13 1 1 1 1 1 1 1 1 1 1 1 1 1 0 1 1 1 1 1 1 1 1 1 1 1 1 1 1 1 1 1 1 1 1 1 1 1 1 1 1 1 1 1 1 1 1 1 1 1 1 1 0 1 1 1 1 1 1 1 1 1 1 1 1 1 1 1 1 1 1 1 1 0 1 1 1 1 1 1 1 1 1 1 1 1 1 4 4 13 13 13 13
13 13 13 13 4 4 13 13 1 1 1 1 1 1 1 0 0 0 0 0 0 1 0 1 1 1 1 1 1 1 1 1 1 1 1 1 1 1 0 0 1 1 1 1 1 1 1 1 1 1 1 1 1 1 1 1 1 1 1 1 1 1 1 1 1 1 1 1 1 1 1 1 1 1 1 1 1 1 1 1 1 1 1 1 1 1 1 1 1 1 1 1 1 1 4 4 13 13 13 13
13 13 13 4 4 4 13 13 1 1 1 1 1 1 1 1 1 1 1 1 1 1 1 0 0 1 1 1 1 1 1 1 1 1 1 1 1 1 1 1 1 1 1 1 1 1 1 1 1 1 1 1 5 1 1 1 1 1 1 1 1 1 1 1 1 1 1 1 1 1 1 1 1 1 1 0 0 0 1 1 1 1 1 1 1 1 1 1 1 1 1 1 1 1 4 4 13 13 13 13
13 13 13 4 4 4 13 13 1 1 1 1 1 1 1 1 1 1 1 1 1 1 1 1 1 0 1 1 1 1 1 1 1 1 1 1 1 1 1 1 1 1 1 1 1 1 1 1 1 1 1 1 1 1 1 1 1 1 1 1 1 1 1 1 1 0 1 1 1 1 1 1 1 1 1 1 1 1 1 1 1 1 1 1 1 1 1 1 1 1 1 1 1 1 4 4 13 13 13 13
13 13 13 4 4 4 13 13 1 1 1 1 1 1 1 1 1 1 1 1 1 1 1 1 1 1 1 1 1 1 1 1 1 1 1 1 1 1 1 1 1 1 1 1 1 1 1 1 1 1 1 1 1 1 1 1 1 1 1 1 1 1 1 1 1 1 1 1 1 1 1 1 1 1 1 1 1 1 1 1 1 1 1 1 1 1 1 1 1 1 1 1 1 1 4 4 13 13 13 13
13 13 13 4 4 4 13 13 1 1 1 1 1 1 1 1 1 1 1 1 1 1 1 1 1 1 1 1 1 1 1 1 1 1 1 1 1 1 1 1 1 1 1 1 1 1 1 1 1 1 1 1 5 5 1 1 1 1 1 1 1 1 1 1 1 1 1 1 1 1 1 1 1 1 1 1 1 1 1 1 1 1 1 1 1 1 1 1 1 1 1 1 1 1 4 4 13 13 13 13
13 13 13 4 4 4 13 13 1 1 1 1 1 1 1 1 1 1 1 1 1 1 1 1 1 1 1 1 1 1 1 1 1 1 1 1 1 1 1 1 1 1 1 1 1 1 1 1 1 1 1 1 5 5 1 1 1 1 1 1 1 1 1 1 1 1 1 1 1 1 1 1 1 1 1 1 1 1 1 1 1 1 1 1 1 1 1 1 1 1 1 1 1 1 4 4 13 13 13 13
13 13 13 4 4 4 13 13 1 1 1 1 1 1 1 1 1 1 1 1 1 1 1 1 1 1 1 1 1 1 1 1 1 1 1 1 1 1 1 1 1 1 1 1 1 1 1 1 1 1 1 1 5 5 1 1 1 1 1 1 1 1 1 1 1 1 1 1 1 1 1 1 1 1 1 1 1 1 1 1 1 1 1 1 1 1 1 1 1 1 1 1 1 1 4 4 13 13 13 13
13 13 13 4 4 4 13 13 13 13 13 13 13 13 13 13 13 13 13 13 13 13 13 13 13 13 13 13 13 13 13 13 13 13 13 13 13 13 13 13 13 13 13 13 13 13 13 13 13 13 13 13 5 5 13 13 4 4 4 4 4 4 4 4 4 4 4 4 4 4 4 4 4 4 4 4 4 4 4 4 4 4 4 4 4 4 4 4 4 4 4 4 4 4 4 13 13 13 13 13
13 13 13 4 4 4 13 13 13 4 4 4 4 4 4 13 13 4 4 13 13 13 13 4 4 4 4 4 4 4 4 4 4 4 4 4 4 4 4 4 4 4 4 4 4 4 4 4 4 4 4 4 5 5 5 13 13 13 13 4 4 4 4 4 4 4 4 4 4 4 4 4 4 4 4 4 4 4 4 4 4 4 4 4 4 4 4 4 4 4 4 4 4 4 4 4 13 4 13 13
13 13 13 4 4 4 4 13 13 13 4 4 4 4 4 4 4 4 4 4 4 4 4 1 4 4 4 4 4 4 4 4 4 4 4 4 4 4 4 4 4 4 4 4 4 4 4 4 4 4 4 4 5 5 5 4 4 4 4 4 4 4 4 4 4 4 4 4 4 4 4 4 4 4 4 4 4 4 4 4 4 4 4 4 4 4 4 4 4 4 4 4 4 4 4 4 13 13 13 13
13 13 13 13 13 13 13 13 13 13 13 13 13 13 13 13 13 4 4 4 4 4 4 4 4 4 4 4 4 4 4 4 4 4 4 4 4 4 4 4 4 4 4 4 4 4 4 4 4 4 4 4 5 5 5 4 4 13 4 4 4 4 4 4 4 4 4 4 13 13 4 4 4 4 13 13 4 4 4 4 4 4 4 4 4 4 4 13 13 13 13 13 13 13 13 13 13 13 13 13
13 13 13 13 13 13 13 13 13 13 13 13 13 13 13 13 13 13 13 13 13 13 13 13 13 13 13 13 13 13 13 13 13 13 13 13 13 13 13 13 13 13 13 13 13 13 13 13 13 13 1 4 5 4 5 4 4 13 13 13 13 13 13 13 13 13 13 13 13 13 13 13 13 13 13 13 13 13 13 13 13 13 13 13 13 13 13 13 13 13 13 13 13 13 13 13 13 13 13 13
13 13 13 13 13 13 13 13 13 13 13 13 13 13 13 13 13 13 13 13 13 13 13 13 13 13 13 13 13 13 13 13 13 13 13 13 13 13 13 13 13 13 13 13 13 13 13 13 13 13 13 13 5 13 5 13 13 13 13 13 13 13 13 13 13 13 13 13 13 13 13 13 13 13 13 13 13 13 13 13 13 13 13 13 13 13 13 13 13 13 13 13 13 13 13 13 13 13 13 13
13 13 13 13 13 13 13 13 13 13 13 13 13 13 13 13 13 13 13 13 13 13 13 13 13 13 13 13 13 13 13 13 13 13 13 13 13 13 13 13 13 13 13 13 13 13 13 13 13 13 13 13 5 13 13 13 13 13 13 13 13 13 13 13 13 13 13 13 13 13 13 13 13 13 13 13 13 13 13 13 13 13 13 13 13 13 13 13 13 13 13 13 13 13 13 13 13 13 13 13
