1 4 1 6 6 8 8 8 8 8 8 8 8 8 8 8 8 8 8 8 8 8 8 8 8 8 8 8 8 8 8 8 8 8 8 8 8 8 8 8 8 8 8 8 8 8 8 8 8 3
1 1 1 3 6 10 10 10 10 10 10 10 10 10 10 10 10 10 10 10 10 10 10 10 10 10 10 10 10 10 10 10 10 10 10 10 10 10 10 10 10 10 10 10 10 10 10 10 8 3
4 1 1 3 3 1 0 1 1 1 1 1 1 1 1 0 1 1 1 1 1 1 1 1 1 1 1 1 1 1 1 1 1 1 1 1 1 1 1 1 1 1 1 1 1 1 1 1 3 3
1 1 4 3 3 1 1 1 1 1 1 0 1 1 1 1 1 1 1 1 6 10 10 10 10 10 10 10 10 10 10 10 10 10 10 10 8 1 1 1 1 1 1 1 1 1 1 1 3 3
1 1 1 3 3 1 1 6 10 10 10 10 10 10 10 8 4 1 1 1 3 15 15 15 15 15 15 15 15 15 15 15 15 15 15 15 3 1 1 1 1 4 1 1 1 1 1 1 3 3
1 1 1 3 3 1 1 3 15 15 15 15 15 15 15 3 1 1 1 1 3 15 15 15 15 15 15 15 15 15 15 15 15 15 15 15 3 1 1 1 1 1 1 1 1 1 1 1 3 3
1 4 1 3 3 1 1 3 15 15 15 15 15 15 15 3 1 1 1 4 3 15 15 15 15 15 15 15 15 15 15 15 15 15 15 15 3 1 4 1 1 1 0 1 1 0 1 1 3 3
4 1 1 3 3 1 1 3 15 15 15 15 15 15 15 3 1 1 1 1 3 15 15 15 15 15 15 6 10 10 10 1 1 10 10 10 9 1 1 1 1 1 1 1 1 1 1 1 3 3
1 1 4 3 3 0 1 3 15 15 15 15 15 15 15 3 0 0 1 1 3 15 15 15 15 15 15 3 0 1 1 5 5 1 1 0 1 1 1 1 1 1 1 1 1 1 1 1 3 3
1 1 1 3 3 1 1 3 15 15 15 15 15 15 15 15 5 5 4 1 3 15 15 15 15 15 15 3 1 1 0 5 5 0 1 1 1 1 1 1 1 4 1 1 1 1 1 1 3 3
1 1 1 3 3 1 1 3 15 15 15 15 15 15 15 15 5 5 1 1 3 15 15 15 15 15 15 3 1 1 1 5 5 1 1 1 1 1 1 1 1 1 1 1 1 1 1 1 3 3
1 4 1 3 3 1 0 3 15 15 15 15 15 15 15 3 5 5 1 1 3 15 15 15 15 15 15 3 1 1 1 5 5 1 1 1 1 0 1 1 1 1 1 13 13 13 1 1 3 3
1 1 1 3 3 1 1 3 15 15 15 15 15 15 15 3 5 5 1 1 3 15 15 15 15 15 15 3 1 1 1 5 5 1 0 1 1 1 1 1 1 13 13 13 1 13 13 13 3 3
4 1 1 3 3 1 1 3 15 15 15 15 15 15 15 3 5 5 1 4 3 15 15 15 15 15 15 3 1 1 1 5 5 1 1 1 1 1 4 1 1 13 1 1 1 1 1 1 3 3
1 1 1 3 3 1 1 3 15 15 15 15 15 15 15 3 5 5 1 1 3 15 15 15 15 15 15 3 1 1 1 5 5 1 1 1 1 1 1 1 1 13 1 1 1 1 1 1 3 3
1 4 1 3 3 1 1 3 15 15 15 15 15 15 15 3 5 5 1 1 3 15 15 15 15 15 15 3 1 1 1 5 5 1 1 1 1 1 1 1 1 13 1 1 1 1 1 1 3 3
6 6 6 6 3 0 1 7 10 10 10 10 10 10 10 9 5 5 1 4 3 15 15 15 15 15 15 3 1 1 1 5 5 1 1 1 1 1 1 1 1 13 1 1 1 1 1 1 3 3
10 10 10 10 9 1 1 1 1 1 1 1 1 0 1 1 5 5 1 1 3 15 15 15 15 15 15 3 1 1 1 5 5 1 1 4 1 1 1 1 0 13 1 1 1 1 1 1 3 3
4 4 4 1 1 1 1 1 1 1 1 0 1 1 1 1 5 5 1 1 7 10 12 15 15 11 10 9 1 1 1 5 5 1 1 1 1 1 1 1 1 13 1 1 1 1 1 1 3 3
1 1 1 1 1 1 1 1 4 1 1 1 1 1 1 1 5 5 1 1 0 0 1 5 5 1 0 0 1 1 1 5 5 1 1 1 1 1 1 0 1 13 1 1 1 1 1 1 3 3
1 1 1 1 1 0 1 1 1 1 1 1 1 1 1 1 5 5 1 1 0 1 1 5 5 1 1 0 1 1 1 5 5 1 1 1 1 1 1 1 1 13 1 1 1 1 1 1 3 3
1 1 1 1 1 1 1 1 4 1 1 1 1 1 1 1 5 5 1 1 1 1 1 5 5 1 1 1 1 1 1 5 5 1 1 0 1 4 1 1 1 13 1 1 1 1 1 1 3 3
1 1 1 1 1 1 1 1 1 1 1 1 1 4 1 1 5 5 1 1 1 0 5 5 5 5 0 1 1 1 1 5 5 1 1 1 1 1 1 1 1 13 1 1 1 1 1 1 3 3
1 1 0 0 0 0 0 0 0 1 1 1 1 1 1 1 5 5 4 4 0 5 6 10 10 8 5 0 1 4 4 5 5 1 1 1 1 1 1 0 0 0 1 1 1 1 1 1 2 2
5 5 5 5 5 5 5 5 5 5 5 5 5 5 5 5 5 5 5 5 5 5 3 2 2 3 5 5 5 5 5 5 5 5 5 5 5 5 5 5 5 5 1 1 1 1 1 1 2 2
5 5 5 5 5 5 5 5 5 5 5 5 5 5 5 5 5 5 5 5 5 5 3 2 2 3 5 5 5 5 5 5 5 5 5 5 5 5 5 5 5 5 1 1 1 1 1 1 2 2
1 1 0 0 0 0 0 0 0 5 5 1 1 1 4 1 1 1 1 1 0 5 7 10 10 9 5 0 1 1 1 5 5 1 4 1 1 1 1 0 0 0 1 1 1 1 1 1 2 2
1 1 1 1 1 1 1 1 1 5 5 1 4 1 1 1 4 1 1 1 1 0 5 5 5 5 0 1 1 1 1 5 5 1 1 1 1 1 4 1 1 13 1 1 1 1 1 1 3 3
1 1 1 0 1 1 1 1 1 5 5 1 1 1 1 1 1 1 4 1 1 1 1 4 1 1 1 1 1 1 1 5 5 1 0 1 1 1 1 1 1 13 1 1 1 1 1 1 3 3
1 1 1 1 1 0 1 1 1 5 5 6 10 10 10 10 10 8 1 1 1 1 1 1 1 1 1 1 1 1 1 5 5 1 1 1 4 1 1 0 1 13 1 1 1 1 1 1 3 3
1 1 1 1 1 1 1 1 1 5 5 3 15 15 15 15 15 3 1 1 1 1 1 4 1 1 1 1 1 1 1 5 5 1 1 1 1 1 1 1 0 13 1 1 1 1 1 1 3 3
4 4 4 1 1 1 1 1 1 5 5 3 15 15 15 15 15 3 1 4 1 0 1 1 1 0 1 1 1 1 1 5 5 1 4 1 1 0 1 1 1 13 1 1 1 1 1 1 3 3
6 6 6 6 8 1 1 1 1 5 5 3 15 15 15 15 15 3 1 1 1 1 1 1 1 1 1 1 0 1 1 5 5 1 1 1 1 1 1 1 4 13 1 1 1 1 1 1 3 3
7 10 10 6 3 4 4 4 4 5 5 3 15 15 15 15 15 3 1 1 0 1 1 0 1 1 4 1 1 1 1 5 5 1 1 1 1 1 1 1 1 13 1 1 1 1 1 1 3 3
1 1 1 3 3 1 1 4 1 5 5 3 15 15 15 15 15 3 1 1 1 1 1 0 1 1 1 1 1 1 1 5 5 1 0 1 1 4 1 1 1 13 1 1 1 1 1 1 3 3
4 1 1 3 3 1 0 0 1 5 5 15 15 15 15 15 15 3 1 1 1 1 1 1 1 1 1 1 1 1 1 5 5 1 1 1 1 1 1 1 0 13 1 1 1 1 1 1 3 3
1 1 4 3 3 1 0 0 1 5 5 15 15 15 15 15 15 3 1 1 1 1 0 1 1 0 1 1 1 1 1 5 5 1 1 1 1 1 1 4 1 13 1 1 1 1 1 1 3 3
1 1 1 3 3 1 1 1 1 5 5 3 15 15 15 15 15 3 1 0 1 1 1 1 1 1 1 1 1 1 1 5 5 1 1 4 1 1 1 1 1 13 13 13 1 13 13 13 3 3
1 1 1 3 3 4 1 1 1 5 5 3 15 15 15 15 15 3 1 1 1 4 1 1 1 1 1 1 1 1 1 5 5 1 1 1 1 1 1 1 1 1 1 13 13 13 1 1 3 3
1 4 1 3 3 1 1 4 1 5 5 3 15 15 15 15 15 3 1 1 1 1 0 1 4 1 1 1 0 1 1 5 5 1 1 1 0 1 1 1 1 1 1 1 1 1 1 0 3 3
1 1 1 3 3 1 1 1 1 5 5 3 15 15 15 15 15 3 1 1 1 1 1 1 1 1 1 1 1 1 1 5 5 1 1 1 1 1 1 1 1 1 1 1 1 1 1 1 3 3
1 1 1 3 3 1 1 1 1 5 5 3 15 15 15 15 15 3 1 1 1 1 1 1 1 1 1 4 1 1 1 5 5 1 1 0 1 1 1 0 1 1 1 1 1 4 1 1 3 3
4 1 1 3 3 1 1 1 1 1 1 7 10 10 10 10 10 9 1 1 1 1 1 1 1 1 1 1 1 1 1 1 1 1 1 1 1 1 4 1 1 1 1 1 1 1 4 1 3 3
1 1 1 3 3 1 1 0 1 1 1 1 1 1 1 1 1 1 1 1 1 1 1 1 1 1 1 1 1 1 1 1 1 1 4 1 1 1 1 1 1 1 1 1 1 1 1 1 3 3
1 4 1 3 3 1 1 1 1 1 1 1 1 1 1 1 1 4 1 1 0 1 1 1 1 1 4 1 0 1 1 1 1 1 1 1 1 0 1 1 1 1 1 0 1 1 1 1 3 3
4 1 1 3 3 1 1 0 1 1 4 1 1 0 1 1 1 1 1 1 1 1 1 1 1 1 1 1 1 1 1 1 1 1 1 1 1 1 1 1 1 1 1 1 1 1 1 1 3 3
1 1 4 3 3 0 1 1 1 1 1 1 1 1 1 1 1 1 1 1 4 1 1 1 1 1 1 1 1 1 1 0 1 1 1 1 1 1 1 1 1 1 1 1 1 1 0 1 3 3
4 1 1 3 3 1 1 1 1 1 1 1 1 1 1 1 1 1 1 1 1 1 1 1 1 1 1 1 1 1 1 1 1 1 1 1 1 1 1 1 1 1 1 1 1 1 1 1 3 3
1 1 1 3 6 8 8 8 8 8 8 8 8 8 8 8 8 8 8 8 8 8 8 8 8 8 8 8 8 8 8 8 8 8 8 8 8 8 8 8 8 8 8 8 8 8 8 8 3 3
4 4 1 7 10 10 10 10 10 10 10 10 10 10 10 10 10 10 10 10 10 10 10 10 10 10 10 10 10 10 10 10 10 10 10 10 10 10 10 10 10 10 10 10 10 10 10 10 10 9
